R 1900 1200
NO ./mossy.xpm
SO ./colorstone.xpm
WE ./bluestone.xpm
S ./pillar.xpm
EA ./redbrick.xpm
F 100,255,244
C 180,190,130
1111111111111111111111111
1000000000110000000000001
1011020001110000000000201
1001000000000000000000001111111111
1111111110110000011100000000000001
1000000000110000011101111111111111
111101111111110111000000100111
11110111111111011101010212001
110E000001101010111000020201111
10000000000020000000000000001
100000000000000011000000000011
11000001110101011111010110011
11110111 1110101 101110010001
11111111 1111111 111111111111